{
  "Name": "Entrance Hallway",
  "Description": "The Main Entrance hall",
  "PlayerSpawnX": 1,
  "PlayerSpawnY": 2,
  "TileSizeX": 32,
  "TileSizeY": 32,
  "TileMap": [
    [ 1, 1, 2, 1, 1, 2, 1, 1, 2, 1, 1, 1 ],
    [ 1, 0, 0, 0, 0, 0, 0, 0, 0, 0, 0, 3 ],
    [ 1, 0, 0, 0, 0, 0, 0, 0, 0, 0, 0, 3 ],
    [ 1, 0, 0, 0, 0, 0, 0, 0, 0, 0, 0, 3 ],
    [ 1, 1, 2, 1, 1, 2, 1, 1, 2, 1, 1, 1 ]
  ],
  "CollisionMap": [
    [ 1, 1, 0, 1, 1, 0, 1, 1, 0, 1, 1, 1 ],
    [ 1, 0, 0, 0, 0, 0, 0, 0, 0, 0, 0, 0 ],
    [ 1, 0, 0, 0, 0, 0, 0, 0, 0, 0, 0, 0 ],
    [ 1, 0, 0, 0, 0, 0, 0, 0, 0, 0, 0, 0 ],
    [ 1, 1, 0, 1, 1, 0, 1, 1, 0, 1, 1, 1 ]
  ],
  "DoorsMap": [
    [ 1, 1, "Room1", 1, 1, "Room2", 1, 1, "Room3", 1, 1, 1 ],
    [ 1, 0, 0, 0, 0, 0, 0, 0, 0, 0, 0, 3 ],
    [ 1, 0, 0, 0, 0, 0, 0, 0, 0, 0, 0, 3 ],
    [ 1, 0, 0, 0, 0, 0, 0, 0, 0, 0, 0, 3 ],
    [ 1, 1, "Room4", 1, 1, "Room5", 1, 1, "Room6", 1, 1, 1 ]
  ],
  "Tiles": [
    "Floor.png",
    "Wall.png",
    "Door.png",
    "Stairs.png"
  ]
}
